10 10
FFFTFFFFFF
FFFTFFFFFF
TTTTTTTTTT
FFFTFFFFFF
FFFTTTTFFF
FTTTFFTTTF
FFFFFFTFFF
FFFFFFTFFF
FFFFFFTFFF
FFFFFFTFFF
