10 10
FFFFFFFFFF
FFOFFFFFFF
FFFFOFFFFF
FOFFFFFFOF
FFFFFFFFFF
FTTTFFTTTF
FFFFFFFFFF
FFOFFFFOFF
FFFFOFFFFF
FFFFFFFFFF
