10 10
FFFTFFFFFF
FFFTFFFFFF
TTTTTTTTTT
FFFTFFFFFF
FFFTFFFFFF
FTTTTTTTTF
FFFFFFTFFF
FFFFFFTFFF
FFFFFFTFFF
FFFFFFTFFF
