10 10
FFFFFFFFOF
FFFFOFFFFF
FFFFFFFFFF
FFFFFFFFFF
FFFFFFFOFF
FTTTTTTTTF
OFFFFFFFFF
FFFFFFOFFF
FFFFOFFFFF
FOFFFFFFFF
