10 10
FFFTFFOFFF
FFFTFFFFFF
TTTTTTTTTT
FFFTFOFFFF
FFFTFFFFFF
FTTTTTTTTF
FFFFFFTFOF
FFFFFFTFFF
FFFFFFTFFF
FFFFFFTFFF
