10 10
FFFTFFFOFF
FFFTFFFFFF
TTTTTTTTTT
FOFTFFOFFF
FFFTTTTFFF
FTTTFFTTTF
FOFFFFTFFF
FFFOFFTFOF
FFFFFFTFFF
FFFFFFTFFF
